#######################
# Russia
#######################

rus_group = {
	653 654 655 656 657 658 659 660 661 662 663 664 665 666 667 668 669 670
	671 672 673 674 675 676 677 678 679 680 681 682 683 684 685 686 687 688 689
	690 691 692 693 694 695 696 697 698 699 700 701 708 709 710 711
	712 713 714 715 716 717 718 720 721 722 727
}

#######################
# British Isles
#######################
ireland_group = {
	46 47 48 49 50 51 52 53 54 55 3980 3981 3982
}

#######################
# Hansa
#######################

hansa_group = {
	22 26 32 33 34 181 182 183 184 185 186 187 188 194 336 337 338 339 340 341 342 343 344
	345 346 355 356 357 358 361 362 363 364 365 366 367 368 369 370 371 372 373 374 375 376
	377 378 379 380 381 382 383 384 385 386 387 388 389 390 391 392 393 394 395 396 397 398 
	399 400 403 404 408 409 411 413 415 416 417 418 419 420 427 431 432 433 434 435 438 439
	440 442 443 444 445 446 447 456 457 458 469 678 679 680 684 685 686
}

#######################
# Africa
#######################
oromia_group = {
	1724 1725 1726 1727 1728 1729
}

#######################
# Middle East & Persia
ghazi_unity_group = { 599 600 602 603 604 605 608 609 610 611 612 614 615 }


#######################
# Asia
red_turban_group = { 
	1030 1031 1032 1033 1034 1035 1036 1037 1038 1039 1040 1041 1042 1043 1044 1045 1046 1047 1048 1049
	1050 1051 1052 1053 1054 1055 1056 1057 1058 1059 1060 1061 1062 1063 1064 1065 1066 1067
	1068 1069 1070 1071 1072 1073 1074 1075 1076 1077 1078 1079 1080 1081 1082 1083
	1084 1085 1086 1087 1088 1089 1090 1091 1092 1096 1097 1098 1099 1100 1101 1102
	1103 1104 1105 
}

pagan_kingdom_group = {
	1175 1176 1177 1178 1179 1186 1187 1188 1189 1190 1192 1193 1195 1196 1197 1198 1200 1202
}

#######################
# Italy

northitalian_cardinals_group = { 
	132 137 138 204 205 206 207 208 235 237 239 240 242 243 244 245 246 247 248
	249 250 251 252 253 254 255 256 257 259 260 261 262 263 264 265 266
	267 268 269 270 271 282
}

roman_cardinals_group = {
	226 227 228 229 230 231 232 233 234
}

#######################
# the low countries
####################### 
belgium_group = { 191 192 193 194 195 197 200 201 }

#######################
# the thirteen colonies
####################### 
thirteen_colonies_group = {
	2206 2207 2208 2224 2225 2226 2227 2228 2229 2230 2231 2232 2233 2234 2235 2238 2239
	2240 2241 2242 2243 2244 2245 2246 2247 2248 2249 2250 2251 2252 2253 2254 2255 2256 
}

#######################
# Justinian's Realm
####################### 
justinian_realm = {
	91 92 95 96 97 98 99 100 101 108 204 205 206 207 208 209 210 211 212 213 214 215 216 217
	218 219 220 221 222 223 224 225 226 227 228 229 230 231 232 233 234 235 236 237 238 239
	240 241 242 243 244 245 246 247 248 249 250 251 252 253 254 255 256 257 258 259 260 261
	262 263 264 265 266 267 268 269 270 271 272 273 274 529 530 531 532 533 534 535 536 537
	538 539 540 541 542 543 544 545 546 547 548 549 550 551 552 553 554 555 556 557 558 559
	560 561 562 563 564 565 566 567 568 569 570 571 572 573 574 575 576 577 578 579 580 581
	582 583 584 585 586 587 588 589 590 591 592 593 594 595 596 597 598 599 600 601 602 603
	604 605 606 607 608 609 610 611 612 613 614 615 616 617 618 619 620 621 622 623 624 625
	626 627 628 629 630 631 632 633 634 635 636 637 638 639 1552 1554 1555 1556 1557 1560 1606
	1607 1608 1609 1610 1611 1612 1613 1614 1615 1616 1617 1618 1619 1620 1621 1622 1623 1624
	1625 1626 1627 1628 1629 1630 1631 1632 1633 1634 1635 1636 1637 1638 1639 1640 1641 1642
	1643 1644 1645 1646 1647 1648 1649 1650 1651 1652 1653 1654 1655 1656 1657 1658 1659 1660
	1661 1662 1663 1664 1665 1666 1688 1689
}
##########################
# kosj & barbary piraces
barbary_pirate_targets_group = {
	57 58 59 60 62 63 89 95 97 98 99 100 101 102 103 107 108 109 121
	122 128 130 131 132 204 205 206 207 208 209 210 211 212 213 214 215 216 217
	218 219 220 221 222 223 225 226 231 233 235 239 241 242 243 244 248 249 253 254 269 272
	274 531 532 535 536 537 552 568 569 570 571 572 573 574 575
	576 577 578 579 580 596 618 1637 1638 1639 1640 1641 1642 1643 1644
	1647 1648 1649 1650 1653 1654 1657 1659 1660 1661 1662 1664 1666 1668 1671
	1672 1673
}

barbary_pirates_risk_1_group = {
	89 98 99 100 101 102 108 207 208 209 210 211 212 213 214 215 216 217 572
	1640 1641 1642 1643 1644 1647 1648 1649 1650 1653 1654 1657 1659 1660 1661
	1662
}

barbary_pirates_risk_2_group = {
	95 103 109 204 205 206 218 219 221 223 569 570 571 573 574 575 576 577 578
	579 580 618 1637 1638 1639
}

barbary_pirates_risk_3_group = {
	97 121 122 128 130 131 132 220 225 226 239 241 532 535 536 552 568
}

barbary_pirates_risk_4_group = {
	59 60 62 63 107 222 231 233 235 242 243 244 248 249 253 254 269 272 274 531 537 1664 1666 1668
	1671 1672 1673
}

#######################
# religion regions
totemism_group = {
	2132 2133 2134 2135 2136 2137 2138 2139 2140 2141 2142 2143 2144 2145 2146 2147
	2148 2149 2150 2151 2152 2153 2154 2155 2156 2157 2158 2159 2160 2162 2164 2166
	2168 2169 2170 2172 2173 2174 2175 2176 2177 2178 2179 2180 2181 2182 2183 2185
	2186 2187 2189 2190 2191 2193 2194 2196 2197 2198 2199 2200 2201 2203 2204 2205
	2206 2209 2210 2213 2214 2216 2217 2218 2219 2221 2222 2223 2225 2228 2230 2231
	2232 2234 2235 2236 2238 2239 2241 2242 2244 2245 2246 2247 2248 2249 2250 2251
	2252 2253 2254 2255 2256 2257 2258 2259 2260 2261 2262 2263 2264 2265 2266 2267
	2268 2269 2270 2271 2272 2273 2274 2275 2276 2277 2278 2279 2280 2281 2282 2283
	2284 2285 2286 2287 2288 2289 2290 2291 2292 2293 2294 2295 2296 2297 2298 2299
	2300 2301 2302 2303 2304 2305 2306 2307
}

anabaptist_group = { 
	179 180 181 182 183 184 185 186 187 188 189 190 191 200 202 203 276 280 281 283
	284 285 286 317 318 319 336 337
}
